1111111111
10000C0MC1
1P0C0000E1
1111111111