111111111111111
1E1C0000C0000C1
101000C0000P001
101000000000111
1010000C0000001
1100C0000C000C1
100000000000001
           111111111111111