1111111111
10001C00C1
101C0011M1
1P1C0011E1
1111111111