111111
1P0001
101101
1C1EM1
111111