111111
1P0ME1
1E0001
1C0E11
111111
