111111
1P0ME1
1M0001
1C0M11
111111