111111111111111111111111111
1E0000000M00000C00000C00001
101001010010000010100100001
101M01001010101000100100001
1P0000000C00C000000000M0001
111111111111111111111111111