111111
1P0C11
100001666
1C1E11
111111