111111
1P0C11
110001
1C1E11
111111