111111
1P0C11
101011
1C0E11
111111