1111111111111
1M010000000M1
1000011111001
1P0M11100M0C1
10001E0000001
1111111111111