1111111111111111111111
1010001111101110101111
1M101011100C1111111011
10M0000P00E00000M01111
1111111111111111111111