11111111111111111111111111111111111111111
1M000000000000000011111111111111111111111
11111111111111111011111111111111111111111
11111111111111111011111111111111111111111
11111111111111111011111111111111111111111
1M000000000011111011111111111111111111111
11111111111011111011111111111111111111111
11111111111011111011111111111111111111111
11111111111011111011111111111111111111111
1M000011111011111011111111111111111111111
11111011111011111011111111111111111111111
11111011111011111011111111111111111111111
11111011111011111011111111111111111111111
1M0M0PCCCCCCCCCCCCCCCCCCCCCCCCCCCCCCCCCE1
11011111011111011111111111111111111111111
1M011111011111011111111111111111111111111
11111111011111011111111111111111111111111
11111111011111011111111111111111111111111
11111111011111011111111111111111111111111
1M000000011111011111111111111111111111111
11111111111111011111111111111111111111111
11111111111111011111111111111111111111111
11111111111111011111111111111111111111111
1M000000000000011111111111111111111111111
11111111111111111111111111111111111111111
11111111111111111111111111111111111111111
11111111111111111111111111111111111111111
