


	111111111111111
	111111111111111
	11111M111111111
	11111111CCC1111
	1111111111C1111
	111C111111C1M11
	1P00000C000C0E1
	111111111111111