           





111111
1P00E1         
100001          
1C0011
111111





		   